699
20
60
0	0	0	0	0	0	0	0	0	0	0	0	0	0	0	0	0	0	0	0	0	0	0	0	0	0	0	0	0	0	0	0	0	0	0	0	0	0	0	0	0	0	0	0	0	0	0	1	2	3	4	5	6	7	8	9	10	11	12	13	
0	0	0	0	0	0	0	0	0	0	0	0	0	0	0	0	0	0	0	0	0	0	0	0	0	0	0	0	0	0	0	0	0	0	0	0	0	0	0	0	0	0	0	0	0	0	0	14	15	16	17	18	19	20	21	22	23	24	25	26	
0	0	0	0	0	0	0	0	0	0	0	0	0	0	0	0	0	0	0	0	0	0	0	0	0	0	0	0	0	0	0	0	0	0	0	0	0	0	0	0	0	0	0	0	0	0	0	27	28	29	30	31	32	33	34	35	36	37	38	39	
0	0	0	0	0	0	0	0	0	0	0	0	0	0	0	0	0	0	0	0	0	0	0	0	0	0	0	0	0	0	0	0	0	0	0	0	0	0	0	0	0	0	0	0	0	0	0	40	41	42	43	44	45	46	47	48	49	50	51	52	
0	0	0	0	0	0	0	0	0	0	0	0	0	0	0	0	0	0	0	0	0	0	0	0	0	0	0	0	0	0	0	0	0	0	0	0	0	0	0	0	0	0	0	0	0	0	0	53	54	55	56	57	58	59	60	61	62	63	64	65	
0	0	0	0	0	0	0	0	0	0	0	0	0	0	0	0	0	0	0	0	0	0	0	0	0	0	0	0	0	0	0	0	0	0	0	0	0	0	0	0	0	0	0	0	0	0	0	66	67	68	69	70	71	72	73	74	75	76	77	78	
79	80	81	82	83	84	85	86	87	85	88	89	80	90	91	92	93	94	95	96	97	98	99	100	101	102	103	104	105	106	107	108	109	110	111	112	113	114	115	116	117	118	119	102	103	120	118	121	122	123	124	125	126	127	128	129	130	131	132	133	
134	135	136	137	138	139	140	141	142	143	144	145	146	147	148	149	150	151	152	153	154	155	156	157	158	159	160	161	162	163	164	165	166	167	168	169	170	171	172	173	174	175	176	159	160	161	177	178	179	180	181	182	183	184	185	186	187	188	189	190	
191	192	193	153	194	195	196	197	198	199	200	201	202	203	153	204	205	206	207	208	209	210	211	212	213	214	215	216	217	218	219	220	221	222	222	223	224	225	226	222	222	227	228	214	215	216	217	218	219	229	230	231	126	127	232	233	234	235	132	236	
237	238	239	240	241	242	243	237	244	245	246	211	247	207	248	249	250	251	252	253	254	255	256	257	258	259	260	261	262	263	264	265	266	267	267	268	269	270	271	267	267	272	273	259	260	261	274	275	264	276	277	278	279	184	73	280	281	282	189	283	
284	285	286	287	288	289	290	291	292	293	294	295	296	297	298	299	300	301	302	225	226	222	222	303	304	305	306	307	308	309	310	311	312	313	313	314	315	316	317	318	319	320	321	305	306	307	308	309	310	322	323	324	126	127	128	129	130	131	132	325	
326	214	327	217	328	329	219	330	331	332	332	223	333	214	215	334	334	335	336	337	271	267	267	272	338	339	340	341	342	343	344	345	346	347	348	349	350	351	352	353	354	355	356	339	340	341	342	343	344	357	358	182	183	184	185	186	187	188	189	190	
359	259	360	261	274	275	264	361	362	362	363	364	365	259	360	261	274	275	264	366	367	368	368	369	370	371	372	373	374	375	376	377	378	379	380	381	382	383	384	385	386	387	388	371	372	373	374	375	376	389	390	125	126	127	232	233	234	235	132	133	
391	305	306	307	308	309	310	392	393	393	394	395	321	305	306	307	308	309	310	311	396	397	398	399	400	401	402	403	404	405	406	407	408	153	409	410	411	412	153	413	414	415	416	417	418	419	420	421	422	423	230	424	183	184	73	280	281	282	189	425	
426	339	340	341	342	343	344	427	428	428	428	355	356	339	340	341	342	343	344	429	430	431	432	433	434	435	436	437	438	439	440	441	442	140	443	444	445	446	447	448	449	450	451	452	453	334	334	454	455	456	277	457	458	127	128	129	130	131	132	459	
460	461	462	373	374	375	376	463	464	464	465	466	467	461	462	373	374	375	376	468	469	470	471	472	473	474	475	476	477	478	479	480	481	482	483	484	485	486	487	488	489	490	491	492	215	334	334	335	336	493	323	494	495	184	185	186	187	188	189	496	
497	401	498	499	500	501	406	502	503	504	505	506	507	401	402	403	404	405	406	508	509	510	511	512	513	514	515	516	517	518	519	520	156	156	521	522	523	524	525	526	527	528	529	530	531	532	533	534	535	536	537	538	539	540	232	233	234	235	132	541	
542	543	544	545	546	547	548	549	550	551	552	553	554	555	556	557	558	559	560	561	562	563	564	565	566	567	568	569	570	571	572	573	574	575	576	577	578	579	148	580	581	582	583	584	585	586	587	588	589	590	591	592	593	594	73	280	281	282	595	596	
597	598	599	600	601	602	603	604	605	606	607	608	609	610	611	612	613	614	615	616	617	618	619	153	620	621	622	623	624	625	626	627	628	629	630	518	631	632	153	633	634	635	636	637	638	639	640	641	642	643	644	645	646	647	128	129	130	131	648	649	
650	651	652	653	654	655	656	657	658	651	659	660	661	662	663	664	665	666	651	659	660	667	668	669	670	671	672	673	651	659	660	674	675	676	677	654	678	679	669	680	681	665	682	683	684	685	651	686	687	688	689	690	691	692	693	694	695	696	697	698	
