0			0			960			320			4			0			
0			0			480			160			4			0			
0			0			240			80			0			1			5		
240			0			240			80			0			0			
0			80			240			80			0			1			5		
240			80			240			80			0			0			
480			0			480			160			4			0			
480			0			240			80			0			0			
720			0			240			80			0			1			4		
480			80			240			80			0			0			
720			80			240			80			0			1			4		
0			160			480			160			4			0			
0			160			240			80			0			1			5		
240			160			240			80			0			1			1		
0			240			240			80			0			2			0		5		
240			240			240			80			0			2			0		1		
480			160			480			160			4			0			
480			160			240			80			0			2			1		2		
720			160			240			80			0			1			4		
480			240			240			80			0			3			1		2		3		
720			240			240			80			0			2			3		4		
