0			0			2048			816			4			0			
0			0			1024			408			4			0			
0			0			512			204			0			0			
512			0			512			204			0			0			
0			204			512			204			4			0			
0			204			256			102			0			7			38		39		40		41		42		45		46		
256			204			256			102			0			17			47		48		49		50		51		52		53		54		55		56		57		58		59		60		61		62		63		
0			306			256			102			0			23			0		1		2		3		4		5		6		7		8		9		10		11		12		13		34		35		36		37		38		43		44		45		46		
256			306			256			102			0			20			14		15		16		17		18		19		20		21		22		23		24		25		26		27		28		29		30		31		32		33		
512			204			512			204			4			0			
512			204			256			102			0			17			64		65		66		67		68		69		70		71		72		73		74		75		76		77		78		84		85		
768			204			256			102			0			17			79		80		81		82		83		111		112		113		114		115		116		117		118		119		120		121		122		
512			306			256			102			0			20			86		87		88		89		90		91		92		93		94		95		96		97		98		99		100		101		102		103		104		105		
768			306			256			102			0			23			106		107		108		109		110		111		112		113		114		115		116		117		118		119		120		121		122		123		124		125		126		127		128		
1024			0			1024			408			4			0			
1024			0			512			204			0			0			
1536			0			512			204			0			0			
1024			204			512			204			4			0			
1024			204			256			102			0			0			
1280			204			256			102			0			0			
1024			306			256			102			0			2			129		130		
1280			306			256			102			0			0			
1536			204			512			204			0			0			
0			408			1024			408			4			0			
0			408			512			204			4			0			
0			408			256			102			0			0			
256			408			256			102			0			2			32		33		
0			510			256			102			0			0			
256			510			256			102			0			0			
512			408			512			204			4			0			
512			408			256			102			0			11			86		87		88		89		90		91		92		93		94		95		96		
768			408			256			102			0			16			132		133		134		135		136		137		138		139		140		141		142		143		144		145		146		147		
512			510			256			102			0			0			
768			510			256			102			0			14			134		135		136		137		138		139		140		141		142		143		144		145		146		147		
0			612			512			204			0			0			
512			612			512			204			0			0			
1024			408			1024			408			4			0			
1024			408			512			204			4			0			
1024			408			256			102			0			16			148		149		150		151		152		153		154		155		156		157		158		159		160		161		162		163		
1280			408			256			102			0			16			164		165		166		167		168		169		170		171		172		173		174		175		176		177		178		179		
1024			510			256			102			0			15			131		148		149		152		153		154		155		156		157		158		159		160		161		162		163		
1280			510			256			102			0			16			164		165		166		167		168		169		170		171		172		173		174		175		176		177		178		179		
1536			408			512			204			4			0			
1536			408			256			102			0			1			180		
1792			408			256			102			0			0			
1536			510			256			102			0			1			180		
1792			510			256			102			0			0			
1024			612			512			204			0			0			
1536			612			512			204			0			0			
